1111111111111111111111111111111111111111111111111111111111111111111111111
1P000000000000000C0001001003000000001000C00000001000001000001000000000001
1111001111001001201111001111111001111001001001111111001001001001111111001
1001000001001001001001000001000001000001001000001001001001000000000001001
1001001111111111001001001201001111001111001111001001001001111001001111111
1001001001003000000001001000000001000001000C01001000000000001001000001001
1001201021111111111001111111111001001111001001111001111001111001001001301
1000001001000001000001001001000000001C00001001001001000001000001001000001
1111111001001111001031001001111111001001001001001111001111111111001001001
1000001001001000001001000001000001001001001000001001000001000001001001001
1111001001001111111001111001001001111001111111111001001111111001111111001
1000000020000000000000C000000C1200000001001000000000000000000001001000001
1111001111001001001001111001111001001001001001111111111111111001001111111
1000001000001001001001001001001001001000000000000000000001001001000001001
1001111001111001111111001111001111111111111001001111111111001111001111001
1001000001000000000000000001000000000000000001001001001001001000000000001
1001111111111001111111111111001111111111111111111001001001001001111001111
1000001000000000000001000001000000001001001000000001001000000001000000001
1001001001001111111111001001111111111001001001111111001111001001111111111
1001001001000000001000001001000000000000000000001000000000001001000000001
1001111001111111111111001111001001001111001001111001001111001111111111001
10010010C0000000000000000000001001000001001000000001000301001000001000001
1111001111001001111111111111001001111111111111001111111111111001111001011
100000100200100000100C0300000010000000010010C00000000000000000000000002E1
1111111111111111111111111111111111111111111111111111111111111111111111111