11111111111111111111111
1P1010001000010C10000C1
1010001C1001C1010000001
10001001010111010111111
11111000000000000010001
11000011101110011011111
11110000111000100001111
1C0001101001010000000E1
11111111111111111111111