11111111111111111111111
1P1010001020010010000C1
1010001C100100010000001
10001001010111010111111
10001000000000002000E01
11111111111111111111111