11111111111111111111111
1P10100010C0010010000C1
10100010100100010000001
10001001010111010111111
10001000000001002000E01
11111111111111111111111