111111111111111
1P00C0000200001
100121111111111
11002000C0000E1
111111111111111