111111111111111
1010C0100010C01
101010101010101
100010001C001E1
111111111111111