111111111111111
1P00000000000C1
101111111111111
1100000000000E1
111111111111111