111111111111111
1P0000000001C01
101111110111111
10E000010C00001
111111111111111