111111111111111
1P10C010C010001
101010101010101
1000100010001E1
111111111111111