11111111111111111111111
1P10100010C001001000001
10100010100100010000001
10001001010111010111111
100010000000010000000E1
11111111111111111111111